#######################################
# Syntax Coloring Map For Svarv Motion Control
#######################################

#######################################
# Datatypes (KEYWORD1)
#######################################

SvarvMotionControl	KEYWORD1
SvarvMotor	KEYWORD1
SvarvControlMode	KEYWORD1
SvarvConnectionState	KEYWORD1
SvarvErrorCode	KEYWORD1
SvarvPIDType	KEYWORD1
SvarvPID	KEYWORD1
SvarvMotorStatus	KEYWORD1
SvarvMotorConfig	KEYWORD1
SvarvStatusCallback	KEYWORD1
SvarvErrorCallback	KEYWORD1
SvarvConnectionCallback	KEYWORD1

#######################################
# Methods and Functions (KEYWORD2)
#######################################

begin	KEYWORD2
addMotor	KEYWORD2
removeMotor	KEYWORD2
getMotor	KEYWORD2
getAllMotors	KEYWORD2
update	KEYWORD2
emergencyStopAll	KEYWORD2
enableAll	KEYWORD2
disableAll	KEYWORD2
scanForMotors	KEYWORD2
autoConfigureMotors	KEYWORD2
getConnectedMotorCount	KEYWORD2
getCANStatistics	KEYWORD2
isCANHealthy	KEYWORD2
getVersion	KEYWORD2
onAnyError	KEYWORD2
onAnyConnectionChange	KEYWORD2
enableDebug	KEYWORD2

setControlMode	KEYWORD2
moveTo	KEYWORD2
moveBy	KEYWORD2
setVelocity	KEYWORD2
setTorque	KEYWORD2
emergencyStop	KEYWORD2
enable	KEYWORD2
disable	KEYWORD2
setPID	KEYWORD2
setLimits	KEYWORD2
saveConfig	KEYWORD2
loadConfig	KEYWORD2
factoryReset	KEYWORD2
getStatus	KEYWORD2
getPosition	KEYWORD2
getVelocity	KEYWORD2
getTorque	KEYWORD2
isConnected	KEYWORD2
isEnabled	KEYWORD2
hasError	KEYWORD2
getLastError	KEYWORD2
getErrorString	KEYWORD2
clearErrors	KEYWORD2
isAtTarget	KEYWORD2
waitForTarget	KEYWORD2
requestStatusUpdate	KEYWORD2
getNodeId	KEYWORD2
getConfig	KEYWORD2
onStatusUpdate	KEYWORD2
onError	KEYWORD2
onConnectionChange	KEYWORD2

svarvModeToString	KEYWORD2
svarvErrorToString	KEYWORD2
svarvConnectionStateToString	KEYWORD2

#######################################
# Constants (LITERAL1)
#######################################

SVARV_MODE_IDLE	LITERAL1
SVARV_MODE_TORQUE	LITERAL1
SVARV_MODE_VELOCITY	LITERAL1
SVARV_MODE_POSITION	LITERAL1
SVARV_MODE_CALIBRATION	LITERAL1

SVARV_STATE_DISCONNECTED	LITERAL1
SVARV_STATE_CONNECTING	LITERAL1
SVARV_STATE_CONNECTED	LITERAL1
SVARV_STATE_ERROR	LITERAL1

SVARV_ERROR_NONE	LITERAL1
SVARV_ERROR_COMMAND_TIMEOUT	LITERAL1
SVARV_ERROR_OVER_CURRENT	LITERAL1
SVARV_ERROR_OVER_VOLTAGE	LITERAL1
SVARV_ERROR_UNDER_VOLTAGE	LITERAL1
SVARV_ERROR_ENCODER_FAILURE	LITERAL1
SVARV_ERROR_DRIVER_FAILURE	LITERAL1
SVARV_ERROR_CALIBRATION_FAILED	LITERAL1
SVARV_ERROR_POSITION_LIMIT	LITERAL1
SVARV_ERROR_VELOCITY_LIMIT	LITERAL1
SVARV_ERROR_CURRENT_LIMIT	LITERAL1
SVARV_ERROR_COMMUNICATION	LITERAL1
SVARV_ERROR_WATCHDOG	LITERAL1
SVARV_ERROR_INVALID_PARAMETER	LITERAL1
SVARV_ERROR_MEMORY_CORRUPTION	LITERAL1

SVARV_PID_POSITION	LITERAL1
SVARV_PID_VELOCITY	LITERAL1
SVARV_PID_CURRENT	LITERAL1

SVARV_VERSION	LITERAL1
SVARV_VERSION_MAJOR	LITERAL1
SVARV_VERSION_MINOR	LITERAL1
SVARV_VERSION_PATCH	LITERAL1